NO ./textures/wall.xpm
SO ./textures/collectible.xpm
WE ./textures/exit.xpm
EA ./textures/player3.xpm

F 85,107,47
C 30,144,255

111111111111111111111111
1000000000S0000000000001
100000000000000000000001
100000000000000000000001
100000111110000101010001
100000100010000000000001
100000100010000100010001
100000100010000000000001
100000110110000101010001
100000000000000000000001
100000000000000000000001
100000000000000000000001
111111111111111111111111