NO ./textures/wall.xpm
SO ./textures/collectible.xpm
WE ./textures/exit.xpm
EA ./textures/player3.xpm

F 85,107,255
C 30,144,255

11111
10001
10S01
10001
11111
