NO ./textures/wall.xpm
SO ./textures/collectible.xpm
WE ./textures/exit.xpm
EA ./textures/player3.xpm

F 255,255,255
C 0,0,0

11111
11101
11001
10N01
10001
10001
11111
